('I', 'DATA_Core_NPD', 'Core (NPD)', 'False', 'A', '2', '0', '900'),
('I', 'DATA_Petrography_NPD', 'Petrography (NPD)', 'False', 'A', '2', '1', '901'),
('I', 'DATA_CO2_NPD', 'CO2 Content (NPD)', 'False', 'A', '2', '1', '902'),
('I', 'DATA_OilSample_NPD', 'Oil Sample (NPD)', 'False', 'A', '2', '1', '903'),
('I', 'DATA_Lithostrat_NPD', 'Lithostratigraphy (NPD)', 'False', 'A', '2', '0', '904'),
('I', 'DATA_DrillStemTest_NPD', 'Drill Stem Test (NPD)', 'False', 'A', '2', '1', '905'),
('I', 'DATA_CasingLOT_NPD', 'Casing and LOT (NPD)', 'False', 'A', '2', '1', '906'),
('I', 'DATA_DrillingMud_NPD', 'Drilling Mud (NPD)', 'False', 'A', '2', '1', '907');


wells = Table('WELLS', metadata, autoload=True, autoload_with=engine)
wellsuserfieldsvalues = Table('t_WellsUserFieldsValues', metadata, autoload=True, autoload_with=engine)
wellsuserfields = Table('t_WellsUserFields', metadata, autoload=True, autoload_with=engine)
projects = Table('PROJECTS', metadata, autoload=True, autoload_with=engine)
wellqueries = Table('WELLQUERIES', metadata, autoload=True, autoload_with=engine)
projectwells = Table('PROJECTWELLS', metadata, autoload=True, autoload_with=engine)
tablesnames = Table('tablenames', metadata, autoload=True, autoload_with=engine)
intervalcolumns = Table('INTERVALCOLUMNS', metadata, autoload=True, autoload_with=engine)
datacore = Table('DATA_Core_NPD', metadata, autoload=True, autoload_with=engine)
datapetrography = Table('DATA_Petrography_NPD', metadata, autoload=True, autoload_with=engine)
dataco2 = Table('DATA_CO2_NPD', metadata, autoload=True, autoload_with=engine)
dataoilsample = Table('DATA_OilSample_NPD', metadata, autoload=True, autoload_with=engine)
datalithostrat = Table('DATA_Lithostrat_NPD', metadata, autoload=True, autoload_with=engine)
datadrillstemtests = Table('DATA_DST_NPD', metadata, autoload=True, autoload_with=engine)
datacasing = Table('DATA_CasingLOT_NPD', metadata, autoload=True, autoload_with=engine)
datadrillingmud = Table('DATA_DrillingMud_NPD', metadata, autoload=True, autoload_with=engine)



# Write df to database

df_dbodataoilsample.to_sql('DATA_OilSample_NPD', engine, if_exists='append', index = False)

print('dbo.DATA_OilSample_NPD')
sqlselect_rows([dataoilsample])




sql = " SELECT * FROM DATA_OilSample_NPD "
pd.read_sql_query(sql, engine)


Integer() - INT
String() - ASCII strings - VARCHAR
Unicode() - Unicode string - VARCHAR or NVARCHAR depending on database
Boolean() - BOOLEAN, INT, TINYINT depending on db support for boolean type
DateTime() - DATETIME or TIMESTAMP returns Python datetime() objects.
Float() - floating point values
Numeric() - precision numbers using Python Decimal()